Concept: NAME-OF

DEFINITION	VALUE	The relation between a name and the object whose name it is.

IS-A	VALUE	PERSONAL-DATA

SUBCLASSES	VALUE	ALIAS-OF
			FIRST-NAME-OF
			LAST-NAME-OF
			MIDDLE-INITIAL-OF
			MIDDLE-NAME-OF
			TITLE-OF

DOMAIN	RELAXABLE-TO	ANY-STRING
	SEM		NAME

INVERSE	VALUE	HAS-NAME

RANGE	SEM	ARTIFACT
		HUMAN
		HUMAN
		ORGANIZATION


Inherited from: PROPERTY

CAUSED-BY	SEM	EVENT
			PROPERTY

CUSTOMARY-FOR	SEM	ANIMAL

DOMAIN-OF	SEM	CAUSED-BY
			PRECONDITION

HAS-UNEXPECTED-OUTCOME	SEM	OBJECT

PRECONDITION	SEM	EVENT
			PROPERTY

PROPERTY-MEASURED	SEM	EVENT
				MEASURE


Inherited from: ALL

THEME-OF	RELAXABLE-TO	REQUEST-INFO

NOTES	SEM	ALL

